# A new line is necessary at the end of this file.
# An abbreviation starting with 0 will not included in the list 
# of abbreviations, but will be expanded regardless.
+0ST : STMicroelectronics
+0grnoida : Greater Noida
+0in : India
+0ltd : Limited
+0inc : Incorporated
+0slab : Systems Lab
+0dept : Department
+BLDC : Brush-less DC
+ACIM : AC Induction Motor
+BLE : Bluetooth Low Enery
+TCP : Transmission Control Protocol
+UDP : User Datagram Protocol
+0www : World Wide Web
+0PPC: PowerPC
+VLE : Variable Length Encoding
+SIG : Specific Interest Group
+PMSM : Permanant Magnet Synchronous Motor
+ECM : Electronic Commutation Motor
+SoC : System on Chip
+0abbr : abbreviation
+AMG : Analog and MEMS Group
+ASIC : Application Specific Integrated Circuit
+ECU : Engine Control Unit
+CAN : Controller Area Network
+SWD : Single Wire Debug
+SFR : Special Function Register
+OOP : Object-Oriented Programming
+CMSIS : Cortex Microcontroller Software Interface Standard
+BSP : Board Support Packages
+HAL : Hardware Abstraction Layer

